@@@@@@@@@
@       @
@    B  @
@   P  X@
@@@@@@@@@