@@@@@@@@@
@       @
@ P  B  @
@      X@
@@@@@@@@@