@@@@@   @@@@
@X P@   @ X@
@B  @@@@@  @
@        B @
@@@@@@@@   @
       @@@@@